R 750 750
NO ./textures/anime
SO ./textures/animetyan
EA ./textures/test3
WE ./textures/anime
S ./textures/st1
FL ./textures/wall
EG ./textures/eog

C 30,  30, 30

NEXTLEVEL ./maps/lvl3.cub


        1111111111111111111111111
        1000000002113020000000001
        1011000101110000000200001
        1001000100000000000000001
111111111000000101100000000000201
100000200000000201110111110111111
11110100011111011100000010001
11110101111111001101010010001
11000002110101021100000010001
10001200000020001100000010001
10000000000000001101010010201
11000001110101011111011113N41
1111111111111111 111111111111