R 750 750
NO ./textures/wood
SO ./textures/wood
EA ./textures/wood
WE ./textures/wood
S ./textures/st1
FL ./textures/cobblest
EG ./textures/eog

C 30,  30, 30

NEXTLEVEL ./maps/lvl7.cub





1111111111111111111111111
1302000012020020000000031
1011001001110000000200001
1N11200000020000000000001
1111111111111111000000211
111111000100000000000001
100000020000010000201111
100031000010000000011
11111000020000011111
    111111111111