R 750 750
NO ./textures/bluestone
SO ./textures/bluestone
EA ./textures/bluestone
WE ./textures/bluestone
S ./textures/st1
FL ./textures/cobblest
EG ./textures/eog

C 30,  30, 30

NEXTLEVEL ./maps/lvl6.cub





1111111
1000031
1000001
10N0001
111111