R 750 750
NO ./textures/brick
SO ./textures/brick
EA ./textures/brick
WE ./textures/brick
S ./textures/st1
FL ./textures/cobble
EG ./textures/eog

C 30,  30, 30





1111111111111111111111111
1000000000020020000000031
1011000001110000000200001
10N1200001020200000000001
1111111111111111111111111