R 750 750
NO ./textures/test2
SO ./textures/test2
EA ./textures/test2
S ./textures/st1
S1 ./textures/st2
S2 ./textures/st3
S3 ./textures/st4
S4 ./textures/st5
S5 ./textures/st6
TR ./textures/chr2
PR ./textures/PR
PT ./textures/PF
NT ./textures/PF
FL ./textures/wall
EG ./textures/eog
WE ./textures/test2
NG ./textures/test1
HP ./textures/hp

C 30,  30, 30

111111111111111111111111111111
1N0000102000000100002140000001
111000121111110100000140111001
1212001112000001000001101001001
10002012000000010000010010001001
100000101111110120000100100001001
1000001010000100010101101000001001
101111101111111111010100100000010011111111
102000000000000020012102100000001000000001
111111121111111111110101111111111111111101
100000101000000000010120000000000000000021
100000101000000000010111111111111111111101
100000101000000000010000410000000000000101
100000101000000000010000410000000000000101
100000101000000000010000410000000000000101
100000101000000000010000410000000000000101
100000101000000000010111111111111111111101
100000101000000000010122000020000000211101
111111101111111111110111001111211111200021
120000000000000000210000010000100002111101
140100100100100100411111111111002101111101
102000200200000020010000014441001102000001
100100100100100100010000010021000111111101
100200000000022000010000010011111000000101
1401001001001001004100000100000001111111011111111111111111
100002000000000000011111111101010000000001000000000000000111111111111111
100100100100100100012000000111010111111101000000000000001102000000021331
100000200000200000010000000224410100002101000000000000011010010001021001
140100100100100100410000000011400100210101111111111111112000012000011001
100000000000000000212100000001111101110104000000000000000000000000000001
100000000000000000212100000021000004410101111111111111110000012000011001
140100100100100100411101111111000000010101000000000000011010010001001001
120000000000000000010000000000011111110001000000000000001102002000001331
120000000000000000010000001111120000010101000000000000000111111111111111
1001001001001001000100000012000001144101011111111111111111
12200000000000000221000000100011111111010001
11111110011111111111000000100200000000210101
10000010012200000000000000100011111111110101
10000010010011111111111111111210000000010111
100000100100000001000000000011111111111101011111111
100000100100144441000000000100000000122101200000221
100000100100111111111100001000002000100100111111001
100000100120000000200100010000001111120101100221001
111111100111111111100111120000000000002101101001001
120000000000000002100200000211111111111101001001001
120000100100000002100111101110112000000000001000221
120000000000000002100100101000010111111101111111111
120000100100000002100100101000010100000000000001
120000100111110002102111101111110140004141400041
120001200004210002102000002000002140004121400041
111111111111111111111111111111111111111111111111