R 750 750
NO ./textures/wood
SO ./textures/wood
EA ./textures/wood
WE ./textures/wood
S ./textures/st1
FL ./textures/cobble
EG ./textures/eog
NG ./textures/animetyan

C 30,  30, 30

NEXTLEVEL ./maps/lvl3.cub


        1111111111111111111111111
        1000000002110020000000001
        1011000101110000000200001
        1001000100000000000000001
111111111000000101100000000000201
100000200000000201110111110111111
11110100011111011120000010001
11110101111111001101010010001
11300002110101021100000010001
10001200000020001100000010001
10000000000000001101010010201
11000021110101011111011110N41
1111111111111111 111111111111