R 750 750
NO ./textures/test2
SO ./textures/test2
EA ./textures/test2
WE ./textures/test2
S ./textures/st1
FL ./textures/wall
EG ./textures/eog

NEXTLEVEL ./maps/tim.cub

C 30,  30, 30
F 100 , 100 , 100





        1111111111111111111111111
        1000000002110020000000001
        1011000101110000000200001
        1001000100000000000000001
111111111000000101100000000000201
100000200000000201110111110111111
11110100011111011100000010001
11110101111111001101010010001
11000002110101021100000010001
10001200000020001100000010001
10000000000000001101010010201
11000001110101011111011110N41
1111111111111111 111111111111