R 500 500
NO ./textures/test3
SO ./textures/test3
EA ./textures/test3
S ./textures/st1
S1 ./textures/st2
S2 ./textures/st3
S3 ./textures/st4
S4 ./textures/st5
S5 ./textures/st6
TR ./textures/chr2
PR ./textures/PR
PT ./textures/PF
NT ./textures/PF
FL ./textures/wall
EG ./textures/eog
WE ./textures/test3
NG ./textures/anime

NEXTLEVEL ./maps/tim.4.cub

C 30,  30, 30
F 100 , 100 , 100





1111111
1000031
1000001
10N0001
111111